金城江|金城江区
郧县
源汇|源汇区
繁昌|繁昌县
大安|大安区
东城|东城区
昔阳|昔阳县
忻府|忻府区
左权|左权县
鄂温克族自治旗|鄂温克族自治旗
郊区
兰坪白族普米族|兰坪白族普米族自治县
巴宜|巴宜区
南郑|南郑县
五营|五营区
戚墅堰|戚墅堰区
平度|平度市
高碑店|高碑店市
定海|定海区
威宁彝族回族苗族|威宁彝族回族苗族自治县
清流|清流市
大名|大名市
和县
安宁|安宁市
鄜县
依安|依安县
郊区|郊区市
邵武|邵武市
永年|永年区
惠民|惠民市
澄城|澄城县
陈旗|陈旗市
青原|青原区
东坡|东坡市
蕲春|蕲春县
石屏|石屏县
深州|深州市
海林|海林市
高邮|高邮市
瓮安|瓮安县
涪城|涪城区
美姑|美姑县
云龙|云龙县
普格|普格县
澳门|澳门市
木里藏族|木里藏族自治县
肇东|肇东市
三河|三河市
兴安盟|兴安盟
巴音郭楞|巴音郭楞市
汉寿|汉寿县
莲池|莲池区
京山|京山县
梨树|梨树区
平坝|平坝市
睢宁|睢宁县
海丰|海丰县
丁青|丁青县
公安|公安县
北京|北京市
察哈尔右翼前旗|察哈尔右翼前旗
河源|河源市
南湖|南湖区
商邱|商邱市
高陵|高陵县
克孜勒苏柯尔克孜|克孜勒苏柯尔克孜自治州
东风|东风区
市中区
怀集|怀集县
民和回族土族|民和回族土族自治县
波密|波密县
庄浪|庄浪县
湄潭|湄潭县
阜新|阜新市
云和|云和市
阎良|阎良区
东湖|东湖区
肃宁|肃宁县
苏左旗|苏左旗市
狮子山|狮子山区
拉孜|拉孜县
天宁|天宁区
鄞州|鄞州区
大方|大方县
博尔塔拉蒙古|博尔塔拉蒙古自治州
大柴旦行政委员会*|大柴旦行政委员会*
徐水|徐水区
沧县
浦北|浦北县
闸北|闸北区
青山|青山区
新城|新城区
长清|长清区
南木林|南木林县
绥滨|绥滨县
石柱|石柱市
和田地|和田地区
昭阳|昭阳区
黔西|黔西县
双桥|双桥区
华蓥|华蓥市
东营|东营市
婺城|婺城区
四平|四平市
巴南|巴南区
淮阴|淮阴区
得荣|得荣县
临县
闵行|闵行区
绍兴|绍兴县
弥渡|弥渡县
武江|武江区
盐亭|盐亭县
华阴|华阴市
荥阳|荥阳市
登封|登封市
柳江|柳江区
横山|横山县
延川|延川县
双城|双城市
恩阳|恩阳市
高要|高要区
北塘|北塘区
西市区
铁锋|铁锋区
温州|温州市
乌后旗|乌后旗市
喀喇沁左翼蒙古族|喀喇沁左翼蒙古族自治县
镇江|镇江市
白塔|白塔区
古田|古田县
静海|静海区
绥德|绥德县
乐至|乐至县
克拉玛依|克拉玛依市
西山|西山区
冷水滩|冷水滩区
东兰|东兰县
安龙|安龙县
古塔|古塔区
莒县
阿克塞哈萨克族|阿克塞哈萨克族自治县
个旧|个旧市
江苏|江苏省
酆都|酆都县
响水|响水县
万全|万全区
高淳|高淳区
奎屯|奎屯市
当涂|当涂县
鹤壁|鹤壁市
呈贡|呈贡区
信阳|信阳市
德昌|德昌县
南县
吉阳|吉阳区
老城|老城区
和林|和林市
鸡东|鸡东县
迎泽|迎泽区
抚松|抚松县
恩施土家族苗族|恩施土家族苗族自治州
泸西|泸西县
鬱林|鬱林市/郁林市
伊春|伊春区
新安|新安县
长阳土家族|长阳土家族自治县
酒泉|酒泉市
白云鄂博矿|白云鄂博矿区
延安|延安市
邵阳|邵阳县
太平|太平市
安泽|安泽县
西湖|西湖区
乌当|乌当区
托县|托县市
潘集|潘集区
兴隆|兴隆市
兴海|兴海县
霍林郭勒|霍林郭勒市
雅江|雅江县
北关|北关区
三原|三原县
龙南|龙南县
铜鼓|铜鼓市
青阳|青阳县
濮阳|濮阳县
范县
于洪|于洪区
寻邬|寻邬县
兴仁|兴仁县
张店|张店区
盐津|盐津县
用于身份证，济源|用于身份证，济源市不用于身份证
昭通|昭通市
疏附|疏附县
东方|东方市
余干|余干县
自流井|自流井区
名山|名山区
衢江|衢江区
罗源|罗源县
进贤|进贤县
鸡泽|鸡泽县
滁州|滁州市
永昌|永昌县
措美|措美县
潮安|潮安市
永泰|永泰县
新干|新干县
革吉|革吉县
钓鱼岛|钓鱼岛市
根河|根河市
溧水|溧水县
会泽|会泽县
克东|克东县
资阳|资阳市
紫阳|紫阳县
珠山|珠山区
蓟州|蓟州区
白玉|白玉县
麒麟|麒麟区
冀州|冀州市
图木舒克|图木舒克市
宿豫|宿豫区
南溪|南溪区
伊犁|伊犁市
工农|工农市
南江|南江县
平果|平果县
清河|清河市
织金|织金县
荔波|荔波县
孝感|孝感市
上甘岭|上甘岭区
绿园|绿园区
阿合奇|阿合奇县
大安|大安市
凉山彝族|凉山彝族自治州
尼勒克|尼勒克县
布尔津|布尔津县
桑日|桑日县
徽县
绩溪|绩溪县
沙市区
密云|密云县
保亭黎族苗族|保亭黎族苗族自治县
北辰|北辰区
吉木乃|吉木乃县
南山|南山区
娄底|娄底市
瑶海|瑶海区
鹤峰|鹤峰县
平南|平南县
北海|北海市
锡山|锡山区
姑苏|姑苏市
秀屿|秀屿区
文安|文安县
包河|包河区
郿县
罗湖|罗湖区
双江拉祜族佤族布朗族傣族|双江拉祜族佤族布朗族傣族自治县
蕉城|蕉城区
建德|建德市
茌平|茌平县
云阳|云阳县
龙泉驿|龙泉驿区
天水|天水市
丘北|丘北县
禄丰|禄丰县
永登|永登县
麻江|麻江县
康保|康保县
沾化|沾化区
禄劝彝族苗族|禄劝彝族苗族自治县
双辽|双辽市
新源|新源县
湾里|湾里区
东安|东安县
来凤|来凤县
越嶲|越嶲县
黎城|黎城县
廉江|廉江市
港闸|港闸区
大厂回族|大厂回族自治县
建华|建华区
江汉|江汉区
仁化|仁化县
泸县
若羌|若羌县
大石桥|大石桥市
淮阳|淮阳县
栾城|栾城县
黄浦|黄浦区
鲁山|鲁山县
山海关|山海关区
盐田|盐田区
同江|同江市
富顺|富顺县
镇雄|镇雄县
河口瑶族|河口瑶族自治县
惠州|惠州市
余江|余江县
九原|九原区
三水|三水区
阿坝|阿坝县
镇沅彝族哈尼族拉祜族|镇沅彝族哈尼族拉祜族自治县
丽江|丽江市
安平|安平县
桑植|桑植县
郓城|郓城县
长武|长武县
兴县
鳛水|鳛水县
白水|白水县
花溪|花溪区
溧水|溧水市
浙江|浙江省
香河|香河县
下关|下关区
祥云|祥云县
望谟|望谟县
环县
大兴安岭|大兴安岭市
崇礼|崇礼区
昌宁|昌宁县
西双版纳|西双版纳市
东兴|东兴市
河津|河津市
贞丰|贞丰县
高密|高密市
商丘|商丘市
介休|介休市
富锦|富锦市
宝鸡|宝鸡市
偏关|偏关县
宁江|宁江区
辽中|辽中县
梅县区
沐川|沐川县
上犹|上犹县
大理白族|大理白族自治州
霍州|霍州市
庐阳|庐阳区
门源回族|门源回族自治县
巴音郭楞蒙古|巴音郭楞蒙古自治州
科尔沁右翼中旗|科尔沁右翼中旗
呼玛|呼玛县
潍坊|潍坊市
丰满|丰满区
阿里地|阿里地区
烈山|烈山区
金山|金山区
靖边|靖边县
遵义|遵义市
临邑|临邑县
清涧|清涧县
南陵|南陵县
赣县区
夏邑|夏邑县
隆德|隆德县
义县
大足|大足区
新和|新和县
高雄|高雄市
应县
广元|广元市
隆阳|隆阳区
丰镇|丰镇市
封邱|封邱县
高坪|高坪区
衡阳|衡阳县
兴平|兴平市
盘山|盘山县
清江浦|清江浦区
汇川|汇川区
金华|金华市
柯城|柯城区
瑞安|瑞安市
湖南|湖南省
南开|南开区
玉环|玉环县
白银|白银市
李沧|李沧区
颍州|颍州区
浦城|浦城县
肇州|肇州县
乌达|乌达区
普兰店|普兰店市
南浔|南浔区
古县
连云|连云区
察右后旗|察右后旗市
乌苏|乌苏市
南昌|南昌县
丰县
临颍|临颍县
凌河|凌河区
梅江|梅江区
埇桥|埇桥区
揭东|揭东县
三沙|三沙市
江城哈尼族彝族|江城哈尼族彝族自治县
增城|增城市
永胜|永胜县
承德|承德市
景洪|景洪市
肥乡|肥乡县
密云|密云区
秦淮|秦淮区
丹棱|丹棱县
垣曲|垣曲县
柘荣|柘荣县
泉山|泉山区
淮上|淮上区
中江|中江县
梁溪|梁溪市
德保|德保县
鄂前旗|鄂前旗市
石龙|石龙区
荔湾|荔湾区
洛扎|洛扎县
山东|山东省
马边彝族|马边彝族自治县
无为|无为县
子洲|子洲县
永靖|永靖县
姑苏|姑苏区
蒲江|蒲江县
南票|南票区
柳南|柳南区
怀化|怀化市
扶余|扶余市
德清|德清县
荔浦|荔浦县
乐东黎族|乐东黎族自治县
玉州|玉州区
龙海|龙海市
金台|金台区
抚远|抚远市
文成|文成县
西区|西区市
潮安|潮安区
南和|南和县
腾冲|腾冲市
邳州|邳州市
华容|华容区
德阳|德阳市
兴业|兴业县
湛江|湛江市
秀英|秀英区
驿城|驿城区
察哈尔右翼后旗|察哈尔右翼后旗
温岭|温岭市
蚌埠|蚌埠市
辽阳|辽阳县
东山|东山县
巴青|巴青县
梓潼|梓潼县
龙门|龙门市
江夏|江夏区
米东|米东区
杜尔伯特蒙古族|杜尔伯特蒙古族自治县
边坝|边坝县
郁南|郁南县
长垣|长垣县
江北|江北区
北市区
江阳|江阳区
临夏回族|临夏回族自治州
工农|工农区
台北|台北市
黄石港|黄石港区
剑河|剑河县
曲松|曲松县
大通|大通区
铁西|铁西区
二道|二道区
阜阳|阜阳市
延庆|延庆县
鲅鱼圈|鲅鱼圈区
延平|延平区
陵城|陵城区
潜江|潜江市
蜀山|蜀山区
涡阳|涡阳县
瀍河回族|瀍河回族区
始兴|始兴县
岑巩|岑巩县
锦江|锦江区
丹寨|丹寨县
铁山港|铁山港区
平泉|平泉市
左云|左云县
甘孜藏族|甘孜藏族自治州
兖州|兖州市
嵊泗|嵊泗县
台安|台安县
长泰|长泰县
中原|中原市
山阴|山阴县
曲周|曲周县
光泽|光泽县
甘南|甘南县
迎江|迎江区
七星关|七星关区
翔安|翔安区
珠晖|珠晖区
江阴|江阴市
河东|河东区
颍东|颍东区
天心|天心区
临洮|临洮县
八步|八步区
八步|八步市
鹰手营子矿|鹰手营子矿市
临海|临海市
崇仁|崇仁县
靖宇|靖宇县
淮滨|淮滨县
平安|平安县
阿克苏|阿克苏市
万年|万年市
麻章|麻章区
定陶|定陶县
金口河|金口河区
原阳|原阳县
通辽|通辽市
札达|札达县
桐梓|桐梓县
甘洛|甘洛县
诏安|诏安县
凤凰|凤凰县
大余|大余县
柳州|柳州市
绵竹|绵竹市
曲水|曲水县
溆浦|溆浦县
四方|四方区
甘孜|甘孜县
乌前旗|乌前旗市
张湾|张湾区
莲花|莲花县
扎赉诺尔|扎赉诺尔区
双牌|双牌县
凤山|凤山县
泾县
丰都|丰都县
七里河|七里河区
黑河|黑河市
广阳|广阳区
黔南|黔南市
石泉|石泉县
扬州|扬州市
新会|新会区
曲阳|曲阳县
汪清|汪清县
汧阳|汧阳县
洪泽|洪泽区
北流|北流市
宁强|宁强县
石柱土家族|石柱土家族自治县
遂溪|遂溪县
雩都|雩都县
章丘|章丘区
海城|海城区
满城|满城县
龙山|龙山区
大通回族土族|大通回族土族自治县
清原满族|清原满族自治县
氹仔岛|氹仔岛市
大连|大连市
滦平|滦平县
辽阳|辽阳市
乌马河|乌马河区
阿拉善盟|阿拉善盟
浏阳|浏阳市
青河|青河县
剑川|剑川县
会东|会东县
维西傈僳族|维西傈僳族自治县
昌都地|昌都地区
那曲地|那曲地区
虞城|虞城县
霍邱|霍邱县
弓长岭|弓长岭区
富阳|富阳市
花都|花都区
禅城|禅城区
建邺|建邺区
南平|南平市
仲巴|仲巴县
六安|六安市
于阗|于阗县
临澧|临澧县
沿河土家族|沿河土家族自治县
察右中旗|察右中旗市
新罗|新罗区
盘锦|盘锦市
淄博|淄博市
靖安|靖安县
延津|延津县
法库|法库县
科左中旗|科左中旗市
西丰|西丰县
清丰|清丰县
綦江|綦江区
松阳|松阳县
凤庆|凤庆县
呷洛|呷洛县
宝山|宝山区
霍城|霍城县
祁阳|祁阳县
寻乌|寻乌县
赤坎|赤坎区
南川|南川区
富蕴|富蕴县
永吉|永吉县
红岗|红岗区
永平|永平县
万荣|万荣县
共和|共和县
桑珠孜|桑珠孜市
阿城|阿城区
邓州|邓州市
新市区
红星|红星市
广东|广东省
平陆|平陆县
界首|界首市
皮山|皮山县
乌中旗|乌中旗市
昂仁|昂仁县
台州|台州市
港南|港南区
德钦|德钦县
赣榆|赣榆市
任城|任城区
博兴|博兴县
红旗|红旗区
果洛|果洛市
安达|安达市
会宁|会宁县
伊通满族|伊通满族自治县
敦化|敦化市
汝州|汝州市
天柱|天柱县
平桂|平桂区
深泽|深泽县
尉氏|尉氏县
资源|资源县
香坊|香坊区
镜湖|镜湖区
双塔|双塔市
启东|启东市
夏津|夏津县
石首|石首市
城中|城中区
西塞山|西塞山区
合肥|合肥市
米易|米易县
太谷|太谷县
富平|富平县
金山屯|金山屯区
邯郸|邯郸市
亳州|亳州市
武义|武义县
榆林|榆林市
卓尼|卓尼县
保德|保德县
钦北|钦北区
衡东|衡东县
鄂托克前旗|鄂托克前旗
武进|武进区
周至|周至县
尧都|尧都区
磐安|磐安县
吴川|吴川市
右江|右江区
广水|广水市
璧山|璧山市
安义|安义县
云龙|云龙市
盘县
灌阳|灌阳县
汉阳|汉阳区
杭州|杭州市
淅川|淅川县
达州|达州市
云县
融水苗族|融水苗族自治县
云南|云南省
宛城|宛城区
佳木斯|佳木斯市
南长|南长区
和政|和政县
清徐|清徐县
丛台|丛台区
安福|安福县
北碚|北碚区
开原|开原市
潮南|潮南区
内蒙古|内蒙古自治区
秀峰|秀峰区
清远|清远市
库尔勒|库尔勒市
崇川|崇川区
镇海|镇海区
隆昌|隆昌市
东莞|东莞市
龙州|龙州县
科左后旗|科左后旗市
岚山|岚山区
盂县
历城|历城区
桐柏|桐柏县
长治|长治市
余庆|余庆县
江安|江安县
罗城仫佬族|罗城仫佬族自治县
德格|德格县
宁都|宁都县
米林|米林县
武山|武山县
泰宁|泰宁县
金湖|金湖县
和田|和田市
云霄|云霄县
凉城|凉城县
开鲁|开鲁县
田林|田林县
襄垣|襄垣县
静乐|静乐县
龙华|龙华区
海安|海安县
新宾满族|新宾满族自治县
玛纳斯|玛纳斯县
克山|克山县
叙永|叙永县
襄州|襄州区
金塔|金塔县
砀山|砀山县
柳林|柳林县
盐池|盐池县
丹徒|丹徒区
旺苍|旺苍县
玉田|玉田县
嘉兴|嘉兴市
前锋|前锋市
富川瑶族|富川瑶族自治县
谷城|谷城县
三江侗族|三江侗族自治县
乐山|乐山市
肥城|肥城市
夹江|夹江县
关岭布依族苗族|关岭布依族苗族自治县
宁蒗彝族|宁蒗彝族自治县
旬阳|旬阳县
濂溪|濂溪区
镇安|镇安县
蓬溪|蓬溪县
海北|海北市
茶陵|茶陵县
永川|永川区
振安|振安区
相山|相山区
岗巴|岗巴县
东港|东港区
龙圩|龙圩市
凌源|凌源市
安溪|安溪县
滨湖|滨湖区
月湖|月湖区
金湾|金湾区
陇南|陇南市
常州|常州市
广河|广河县
焉耆回族|焉耆回族自治县
密山|密山市
黑山|黑山县
枝江|枝江市
镇赉|镇赉县
安阳|安阳市
巩留|巩留县
尚志|尚志市
南通|南通市
田家庵|田家庵区
定西|定西市
长岛|长岛县
阳春|阳春市
临朐|临朐县
邵阳|邵阳市
汕尾|汕尾市
婼羌|婼羌县
右玉|右玉县
济宁|济宁市
达孜|达孜县
瑞昌|瑞昌市
七星|七星市
成华|成华区
汤阴|汤阴县
兰州|兰州市
溧阳|溧阳市
龙泉|龙泉市
古城|古城区
黄龙|黄龙县
内邱|内邱县
高明|高明市
鹿泉|鹿泉区
宜宾|宜宾市
蒙自|蒙自市
应城|应城市
土默特右旗|土默特右旗
韶山|韶山市
清水|清水县
大同|大同县
随县
泗阳|泗阳县
垦利|垦利县
太白|太白县
潞城|潞城市
社旗|社旗县
扶余|扶余县
罗江|罗江县
湘东|湘东区
金阳|金阳县
文登|文登区
象山|象山区
榆阳|榆阳区
明山|明山区
盐都|盐都区
鱼台|鱼台县
常宁|常宁市
海珠|海珠区
南芬|南芬区
芜湖|芜湖县
葫芦岛|葫芦岛市
吉利|吉利区
尼木|尼木县
阿勒泰地|阿勒泰地区
南市区
泗洪|泗洪县
江南|江南市
郫县
仁布|仁布县
方山|方山县
兴安|兴安区
咸阳|咸阳市
木垒哈萨克|木垒哈萨克自治县
什邡|什邡市
沂南|沂南县
顺昌|顺昌县
拉萨|拉萨市
苏右旗|苏右旗市
三明|三明市
江州|江州区
新郑|新郑市
揭东|揭东区
中阳|中阳县
通化|通化县
双滦|双滦区
恩阳|恩阳区
耀州|耀州区
察右前旗|察右前旗市
云梦|云梦县
沧州|沧州市
长岭|长岭县
福鼎|福鼎市
顺德|顺德区
谯城|谯城区
新泰|新泰市
安源|安源区
岚皋|岚皋县
乌拉特中旗|乌拉特中旗
辽源|辽源市
泽州|泽州县
连云港|连云港市
五通桥|五通桥区
鹤山|鹤山市
曲江|曲江区
正宁|正宁县
青海|青海省
宁陵|宁陵县
临猗|临猗县
吉安|吉安县
茄子河|茄子河区
南华|南华县
阳东|阳东区
曲靖|曲靖市
永宁|永宁县
西吉|西吉县
锡林浩特|锡林浩特市
东丽|东丽区
安塞|安塞区
濉溪|濉溪县
榕城|榕城区
吉林|吉林省
吉林市
龙川|龙川县
农安|农安县
商南|商南县
永清|永清县
新华|新华市
宿城|宿城区
兴庆|兴庆区
桃山|桃山区
江干|江干区
开江|开江县
华池|华池县
巢湖|巢湖市
前郭尔罗斯蒙古族|前郭尔罗斯蒙古族自治县
锺祥|锺祥市
隆回|隆回县
淳安|淳安县
日土|日土县
北仑|北仑区
梁溪|梁溪区
九江|九江市
丰润|丰润区
盈江|盈江县
未央|未央区
望江|望江县
古冶|古冶区
临武|临武县
贺兰|贺兰县
天津|天津市
玉树藏族|玉树藏族自治州
和田|和田县
长顺|长顺县
志丹|志丹县
唐山|唐山市
松原|松原市
栾城|栾城市
驻马店|驻马店市
固原|固原市
文山壮族苗族|文山壮族苗族自治州
观山湖|观山湖市
周口|周口市
山丹|山丹县
石鼓|石鼓区
清城|清城区
头屯河|头屯河区
香洲|香洲区
沾化|沾化县
商城|商城县
马尾|马尾市
温宿|温宿县
黄陂|黄陂区
太子河|太子河区
彭泽|彭泽县
巴中|巴中市
铜仁|铜仁市
岱山|岱山县
荷塘|荷塘区
兰陵|兰陵市
武鸣|武鸣县
阿左旗|阿左旗市
孟连傣族拉祜族佤族|孟连傣族拉祜族佤族自治县
德兴|德兴市
柏乡|柏乡县
紫金|紫金县
铜川|铜川市
正阳|正阳县
瑞丽|瑞丽市
锡林郭勒|锡林郭勒市
沂源|沂源县
阳西|阳西县
桑珠孜|桑珠孜区
巍山彝族回族|巍山彝族回族自治县
源城|源城区
濮阳|濮阳市
城关|城关区
定结|定结县
布拖|布拖县
北屯|北屯市
本溪|本溪市
紫云苗族布依族|紫云苗族布依族自治县
达坂城|达坂城区
同心|同心县
西盟佤族|西盟佤族自治县
麦积|麦积区
迪庆|迪庆市
扶沟|扶沟县
滴道|滴道区
竹溪|竹溪县
揭阳|揭阳市
疏勒|疏勒县
湟源|湟源县
广西|广西省|广西壮族自治区|广西自治区
齐河|齐河县
徐水|徐水县
蓟县
牟定|牟定县
石渠|石渠县
顺平|顺平县
下城|下城区
色达|色达县
鄱阳|鄱阳县
温县
涉县
长洲|长洲区
沈阳|沈阳市
蛟河|蛟河市
扬中|扬中市
叶城|叶城县
新疆|新疆维吾尔自治区|新疆自治区
临夏|临夏市
汉阴|汉阴县
内丘|内丘县
胶南|胶南市
乐昌|乐昌市
良庆|良庆区
叠彩|叠彩区
昌江黎族|昌江黎族自治县
上饶|上饶县
大关|大关县
天山|天山区
蓬江|蓬江区
池州|池州市
平桥|平桥区
张家口|张家口市
辉县市
迭部|迭部县
新乡|新乡县
咸安|咸安区
岭东|岭东区
昭平|昭平县
普兰|普兰市
贵溪|贵溪市
浦口|浦口区
姜堰|姜堰市
龙湾|龙湾区
高州|高州市
都安瑶族|都安瑶族自治县
汉中|汉中市
青浦|青浦区
饶阳|饶阳县
长寿|长寿市
海拉尔|海拉尔区
宁晋|宁晋县
宝安|宝安区
错那|错那县
建阳|建阳区
玉屏侗族|玉屏侗族自治县
东宁|东宁县
章邱|章邱市
端州|端州区
双流|双流区
雄县
和阗|和阗市
冕宁|冕宁县
泉港|泉港区
四川|四川省
镇坪|镇坪县
乌兰浩特|乌兰浩特市
淮南|淮南市
大关|大关市
大同|大同区
文昌|文昌市
惠水|惠水县
和硕|和硕县
潮州|潮州市
晋城|晋城市
桃城|桃城区
沅江|沅江市
荥经|荥经县
大同|大同市
定日|定日县
莲都|莲都区
白银|白银区
罗甸|罗甸县
阿克苏地|阿克苏地区
龙安|龙安区
高青|高青县
鲤城|鲤城区
石阡|石阡县
尼玛|尼玛县
平谷|平谷区
田东|田东县
开封|开封市
兴山|兴山县
泾川|泾川县
郑州|郑州市
沧源佤族|沧源佤族自治县
林甸|林甸县
昌黎|昌黎县
诸城|诸城市
高唐|高唐县
冀州|冀州区
广饶|广饶县
曹县
邱北|邱北县
岳阳楼|岳阳楼区
灵石|灵石县
吴桥|吴桥县
民权|民权县
涞水|涞水县
信丰|信丰县
元谋|元谋县
友谊|友谊县
湖州|湖州市
农安|农安市
石城|石城县
阳东|阳东县
舟曲|舟曲县
黔南布依族苗族|黔南布依族苗族自治州
衡山|衡山县
覃塘|覃塘区
贵阳|贵阳市
曲阜|曲阜市
新邵|新邵县
宁城|宁城县
杨浦|杨浦区
江油|江油市
游仙|游仙市
西宁|西宁市
华安|华安县
乌鲁木齐|乌鲁木齐市
信州|信州区
浦江|浦江县
神木|神木市
崇州|崇州市
馆陶|馆陶县
彰化|彰化市
句容|句容市
安仁|安仁县
高淳|高淳市
会理|会理县
天全|天全县
上虞|上虞市
颍上|颍上县
朝天|朝天区
丰顺|丰顺县
大洼|大洼县
江山|江山市
桂平|桂平市
峨边彝族|峨边彝族自治县
伊川|伊川县
民勤|民勤县
黄南|黄南市
崖州|崖州区
松山|松山区
申扎|申扎县
奎文|奎文区
任邱|任邱市
哈巴河|哈巴河县
朔城|朔城区
东川|东川区
科尔沁左翼中旗|科尔沁左翼中旗
武昌|武昌区
章贡|章贡区
洞头|洞头县
霍山|霍山县
黄石|黄石市
西藏|西藏自治区
碑林|碑林区
新余|新余市
绥中|绥中县
天河|天河区
恭城瑶族|恭城瑶族自治县
厦门|厦门市
越城|越城区
江城|江城区
大观|大观区
寒亭|寒亭区
肥西|肥西县
西乌旗|西乌旗市
建水|建水县
焦作|焦作市
长沙|长沙县
平坝|平坝县
永修|永修县
襄阳|襄阳市
灵川|灵川县
和静|和静县
寿宁|寿宁县
寿光|寿光市
吉利|吉利市
松滋|松滋市
武安|武安市
青神|青神县
屯昌|屯昌县
屏东|屏东市
茫崖|茫崖市
隆尧|隆尧县
长寿|长寿区
莱阳|莱阳市
额济纳旗|额济纳旗
桂阳|桂阳县
武功|武功市
浔阳|浔阳区
石门|石门县
望城|望城区
高台|高台县
临桂|临桂市
昆山|昆山市
洛浦|洛浦县
广宁|广宁县
奉化|奉化区
张家川回族|张家川回族自治县
城厢|城厢区
禹州|禹州市
唐县
浈江|浈江区
阿尔山|阿尔山市
陵县
中方|中方县
乐安|乐安县
仙居|仙居县
株洲|株洲县
雨城|雨城区
大英|大英县
满城|满城区
桦甸|桦甸市
定南|定南县
细河|细河区
龙游|龙游县
昭苏|昭苏县
滦县
牧野|牧野区
吴堡|吴堡县
江都|江都区
威县
神池|神池县
肃北蒙古族|肃北蒙古族自治县
武穴|武穴市
东乌旗|东乌旗市
衢州|衢州市
随州|随州市
离石|离石区
海西蒙古族藏族|海西蒙古族藏族自治州
临沭|临沭县
万全|万全市
长汀|长汀县
涞源|涞源县
绍兴|绍兴市
长丰|长丰县
石狮|石狮市
321002|321002
耿马傣族佤族|耿马傣族佤族自治县
叶集|叶集区
新都|新都区
太湖|太湖县
朝阳|朝阳区
增城|增城区
蒲县
玉林|玉林市
铜梁|铜梁县
灵台|灵台县
奉节|奉节县
汾西|汾西县
呼兰|呼兰区
莎车|莎车县
临汾|临汾市
钟山|钟山县
彭山|彭山县
镶黄旗|镶黄旗
赣榆|赣榆区
武汉|武汉市
炉霍|炉霍县
类乌齐|类乌齐县
点军|点军区
召陵|召陵区
含山|含山县
黔西南布依族苗族|黔西南布依族苗族自治州
吐鲁番地|吐鲁番地区
天涯|天涯市
普宁|普宁市
林芝|林芝市
陈巴尔虎旗|陈巴尔虎旗
牟平|牟平区
册亨|册亨县
积石山保安族东乡族撒拉族|积石山保安族东乡族撒拉族自治县
双河|双河市
滦南|滦南县
鞍山|鞍山市
石峰|石峰区
铜鼓|铜鼓县
宽甸满族|宽甸满族自治县
钦南|钦南区
万州|万州区
巫山|巫山县
雁塔|雁塔区
开平|开平市
怀来|怀来县
南澳|南澳县
上思|上思县
合山|合山市
佛坪|佛坪县
资溪|资溪县
孝南|孝南区
盖州|盖州市
蠡县
上海|上海市
安庆|安庆市
铜官山|铜官山区
岳塘|岳塘区
永安|永安市
宜昌|宜昌市
鄂城|鄂城区
湘乡|湘乡市
赤壁|赤壁市
西双版纳傣族|西双版纳傣族自治州
礼泉|礼泉县
榆树|榆树市
龙圩|龙圩区
台江|台江区
青田|青田县
卢氏|卢氏县
鄂伦春旗|鄂伦春旗市
宝坻|宝坻区
长春|长春市
阿勒泰|阿勒泰市
吴中|吴中区
尚义|尚义县
东明|东明县
海门|海门市
嘉峪关|嘉峪关市
河池|河池市
津南|津南区
崆峒|崆峒区
姜堰|姜堰区
平定|平定县
临沧|临沧市
克拉玛依|克拉玛依区
磐石|磐石市
绥江|绥江县
阳曲|阳曲县
裕民|裕民县
沁阳|沁阳市
青云谱|青云谱区
鹤岗|鹤岗市
大邑|大邑县
新田|新田县
井陉矿|井陉矿区
鸠江|鸠江区
郧阳|郧阳市
芦溪|芦溪县
卢龙|卢龙县
旅顺口|旅顺口区
定兴|定兴县
延边朝鲜族|延边朝鲜族自治州
南谯|南谯区
沈北新|沈北新区
旬邑|旬邑县
平鲁|平鲁区
陇县
武都|武都区
阆中|阆中市
海州|海州区
刚察|刚察县
绥棱|绥棱县
泸水|泸水县
铜官|铜官市
马鞍山|马鞍山市
鸡冠|鸡冠区
商水|商水县
鼓楼|鼓楼市
栾城|栾城区
平乡|平乡县
仓山|仓山区
太仓|太仓市
从化|从化市
高安|高安市
太和|太和县
广宗|广宗县
遂川|遂川县
祁门|祁门县
龙陵|龙陵县
五指山|五指山市
柳江|柳江县
龙港|龙港区
砚山|砚山县
宁陕|宁陕县
莱山|莱山区
武隆|武隆区
长海|长海县
靖西|靖西市
苍南|苍南县
虎丘|虎丘区
涟源|涟源市
惠城|惠城区
黑水|黑水市
彭州|彭州市
芙蓉|芙蓉区
船山|船山区
盱眙|盱眙县
喀什地|喀什地区
宁安|宁安市
荆州|荆州市
久治|久治县
称多|称多县
新民|新民市
昆玉|昆玉市
郧阳|郧阳区
安宁|安宁区
凉州|凉州区
上虞|上虞区
开化|开化县
晋源|晋源区
宁德|宁德市
两当|两当县
辉南|辉南县
蔡甸|蔡甸区
临潼|临潼区
莒南|莒南县
杞县
樊城|樊城区
宜君|宜君县
马山|马山县
莱城|莱城区
闽清|闽清县
全南|全南县
川汇|川汇区
迁安|迁安市
青白江|青白江区
大柴旦|大柴旦市
呼中|呼中区*
周宁|周宁县
翠屏|翠屏区
灌云|灌云县
邗江|邗江区
武夷山|武夷山市
芦淞|芦淞区
沔县
玛沁|玛沁县
托里|托里县
平罗|平罗县
孟村回族|孟村回族自治县
莫力达瓦达斡尔族自治旗|莫力达瓦达斡尔族自治旗
牡丹|牡丹市
宿松|宿松县
南部|南部市
宁河|宁河区
灵武|灵武市
陆河|陆河县
嘉定|嘉定区
上海|上海市
辽中|辽中区
松桃苗族|松桃苗族自治县
裕安|裕安区
邯山|邯山区
南城|南城县
沙洋|沙洋县
沾益|沾益区
南阳|南阳市
奉贤|奉贤区
解放|解放区
开阳|开阳县
古浪|古浪县
崂山|崂山区
叶县
金坛|金坛市
铜山|铜山区
勐海|勐海县
亚东|亚东县
平顶山|平顶山市
米脂|米脂县
亹源回族|亹源回族自治县
中沙|中沙市
泉州|泉州市
武清|武清区
射阳|射阳县
可克达拉|可克达拉市
房山|房山区
睢阳|睢阳区
宣城|宣城市
新龙|新龙县
神农架林|神农架林区
阳高|阳高县
延边|延边市
新巴尔虎右旗|新巴尔虎右旗
金秀瑶族|金秀瑶族自治县
错那|错那市
兰山|兰山区
绥阳|绥阳县
新河|新河县
加查|加查县
普兰店|普兰店区
浑南|浑南区
杨陵|杨陵区
赛罕|赛罕区
红河哈尼族彝族|红河哈尼族彝族自治州
玉泉|玉泉区
亭湖|亭湖区
马尾|马尾区
穆棱|穆棱市
苗栗|苗栗市
分宜|分宜县
杨凌|杨凌市
双湖|双湖县
鄄城|鄄城县
兴宾|兴宾区
景泰|景泰县
孟津|孟津县
玄武|玄武区
清浦|清浦区
吐鲁番|吐鲁番市
方城|方城县
阿右旗|阿右旗市
峨山彝族|峨山彝族自治县
南岗|南岗区
来安|来安县
下陆|下陆区
宁南|宁南县
鹤庆|鹤庆县
宁津|宁津县
屏南|屏南县
嘉鱼|嘉鱼县
隆林各族|隆林各族自治县
黔东南|黔东南市
泰和|泰和县
荆州|荆州区
西陵|西陵区
龙里|龙里县
襄城|襄城区
望都|望都县
五原|五原县
突泉|突泉县
江华瑶族|江华瑶族自治县
塔城地|塔城地区
高陵|高陵市
商都|商都县
江门|江门市
临渭|临渭区
船营|船营区
平泉|平泉县
义安|义安市
安远|安远县
静海|静海县
兴和|兴和县
芮城|芮城县
当阳|当阳市
宁洱哈尼族彝族|宁洱哈尼族彝族自治县
邢台|邢台市
琼结|琼结县
白河|白河县
西乡|西乡县
江川|江川县
桐城|桐城市
安康|安康市
陆川|陆川县
洪雅|洪雅县
银海|银海区
林州|林州市
政和|政和县
武城|武城县
红安|红安县
兴文|兴文县
万山|万山区
原州|原州区
衡水|衡水市
乐业|乐业县
陵川|陵川县
潼关|潼关县
涵江|涵江区
吉州|吉州区
眉县
前进|前进区
沙河|沙河市
平原|平原县
华容|华容县
遂宁|遂宁市
北戴河|北戴河区
靖西|靖西县
双峰|双峰市
易门|易门县
平利|平利县
黑水|黑水县
香格里拉|香格里拉县
顺河回族|顺河回族区
东昌|东昌区
泰兴|泰兴市
毕节|毕节市
东乡族|东乡族自治县
达尔罕茂明安联合旗|达尔罕茂明安联合旗
海西|海西市
五家渠|五家渠市
龙马潭|龙马潭区
美溪|美溪区
高昌|高昌区
阜康|阜康市
兴国|兴国市
贵德|贵德县
铁岭|铁岭市
上街|上街区
互助|互助市
蓝山|蓝山县
阿坝藏族羌族|阿坝藏族羌族自治州
双城|双城区
集美|集美区
同安|同安区
浉河|浉河区
巴彦|巴彦县
桥西|桥西区
伊春|伊春市
灵山|灵山县
尤溪|尤溪县
日照|日照市
海宁|海宁市
老边|老边区
包头|包头市
资阳|资阳区
弋江|弋江区
复兴|复兴区
博野|博野县
金牛|金牛区
华坪|华坪县
三亚|三亚市
让胡路|让胡路区
渭城|渭城区
安新|安新县
二连浩特|二连浩特市
科尔沁右翼前旗|科尔沁右翼前旗
黔东南苗族侗族|黔东南苗族侗族自治州
番禺|番禺区
甘谷|甘谷县
阳信|阳信县
仁怀|仁怀市
克什克腾旗|克什克腾旗
保康|保康县
通渭|通渭县
丹江口|丹江口市
竹山|竹山县
临湘|临湘市
拜城|拜城县
铁东|铁东区
稻城|稻城县
洪江|洪江市
浑源|浑源县
汕头|汕头市
从江|从江县
黄山|黄山区
华县
昌邑|昌邑区
舞阳|舞阳县
香港|香港市
章丘|章丘市
阜宁|阜宁县
扎鲁特旗|扎鲁特旗
新晃侗族|新晃侗族自治县
宣汉|宣汉县
江津|江津区
福绵|福绵市
澄江|澄江县
运城|运城市
射洪|射洪县
高陵|高陵区
高邑|高邑县
宣恩|宣恩县
琼海|琼海市
兰西|兰西县
仁寿|仁寿县
东乡|东乡县
沁源|沁源县
湟中|湟中县
郫都|郫都区
菏泽|菏泽市
泸州|泸州市
东安|东安区
武侯|武侯区
襄城|襄城县
元氏|元氏县
儋州|儋州市
纳雍|纳雍县
西畴|西畴县
凭祥|凭祥市
黄埔|黄埔区
邠县
准格尔旗|准格尔旗
金昌|金昌市
峨眉山|峨眉山市
秦州|秦州区
秀山土家族苗族|秀山土家族苗族自治县
汾阳|汾阳市
息县
清河|清河县
玉树|玉树市
峄城|峄城区
安陆|安陆市
乌审旗|乌审旗
宁夏|宁夏回族自治区|宁夏自治区
新野|新野县
安岳|安岳县
金坛|金坛区
普兰|普兰县
平昌|平昌县
岫岩满族|岫岩满族自治县
新北|新北区
玉环|玉环市
海伦|海伦市
麻阳苗族|麻阳苗族自治县
栒邑|栒邑县
常山|常山县
永顺|永顺县
朝阳|朝阳县
鼎城|鼎城区
潼南|潼南县
崇义|崇义县
伊金霍洛旗|伊金霍洛旗
潍城|潍城区
湖北|湖北省
凌云|凌云县
武鸣|武鸣区
碾子山|碾子山区
南郊|南郊区
惠山|惠山区
岳麓|岳麓区
铅山|铅山县
广丰|广丰区
灯塔|灯塔市
庐山|庐山市
新沂|新沂市
巫溪|巫溪县
浪卡子|浪卡子县
漳县
万安|万安市
肃州|肃州区
务川仡佬族苗族|务川仡佬族苗族自治县
莱州|莱州市
伊吾|伊吾县
安吉|安吉县
恩施|恩施市
南涧彝族|南涧彝族自治县
交口|交口县
望奎|望奎县
武陵|武陵区
南京|南京市
故城|故城县
古交|古交市
临沂|临沂市
通道侗族|通道侗族自治县
长宁|长宁区
正镶白旗|正镶白旗
蓬莱|蓬莱市
同德|同德县
封开|封开县
印台|印台区
义乌|义乌市
威海|威海市
海东地|海东地区
土默特左旗|土默特左旗
九龙|九龙县
万源|万源市
银州|银州区
洪泽|洪泽县
康定|康定市
五寨|五寨县
阳城|阳城县
六枝|六枝市
马关|马关市
长白朝鲜族|长白朝鲜族自治县
阳江|阳江市
都匀|都匀市
通川|通川区
沈河|沈河区
红塔|红塔区
墨玉|墨玉县
铁骊|铁骊市
山亭|山亭区
宣州|宣州区
昌吉回族|昌吉回族自治州
新渝|新渝市
临城|临城县
易县
兰陵|兰陵县
新左旗|新左旗市
礼县
祥符|祥符区
哈密地|哈密地区
港口|港口市
黄山|黄山市
汶上|汶上县
井研|井研县
红寺堡|红寺堡区
宿州|宿州市
电白|电白市
巴宜|巴宜市
二七|二七市
宁化|宁化县
梅列|梅列区
壤塘|壤塘县
张掖|张掖市
恒山|恒山区
前郭|前郭市
祥符|祥符市
宝应|宝应县
麻城|麻城市
塔河|塔河县
余姚|余姚市
涟水|涟水县
连平|连平县
舒城|舒城县
博爱|博爱县
托克托|托克托县
荔城|荔城区
老河口|老河口市
施甸|施甸县
宁武|宁武县
富源|富源县
通海|通海县
哈尔滨|哈尔滨市
长宁|长宁县
郸城|郸城县
淇滨|淇滨区
无棣|无棣县
民丰|民丰县
额敏|额敏县
沙湾|沙湾区
安县
迪庆藏族|迪庆藏族自治州
正定|正定县
宿迁|宿迁市
株洲|株洲市
临翔|临翔区
武陵源|武陵源区
巴塘|巴塘县
芒康|芒康县
重庆|重庆市
定远|定远县
炎陵|炎陵县
双峰|双峰县
罗定|罗定市
天祝藏族|天祝藏族自治县
巴林左旗|巴林左旗
德城|德城区
天长|天长市
上栗|上栗县
鹰手营子矿|鹰手营子矿区
淇县
团风|团风县
望花|望花区
凤凰|凤凰市
内乡|内乡县
前进|前进市
聊城|聊城市
新密|新密市
麻栗坡|麻栗坡县
阿巴嘎旗|阿巴嘎旗
乐清|乐清市
桐庐|桐庐县
汉源|汉源县
扎赉特旗|扎赉特旗
霞浦|霞浦县
新邱|新邱区
蕉岭|蕉岭县
平邑|平邑县
新吴|新吴区
泰顺|泰顺县
龙山|龙山县
晋宁|晋宁区
怀柔|怀柔区
蒲城|蒲城县
佛山|佛山市
宁乡|宁乡县
逊克|逊克县
开平|开平区
晋安|晋安区
罗田|罗田县
中宁|中宁县
矿区|矿区市
成都|成都市
鄂托克旗|鄂托克旗
临漳|临漳县
璧山|璧山区
绵阳|绵阳市
宜川|宜川县
建瓯|建瓯市
峰峰矿|峰峰矿区
松溪|松溪县
肥乡|肥乡区
贡觉|贡觉县
呼伦贝尔|呼伦贝尔市
清新|清新区
三元|三元区
循化撒拉族|循化撒拉族自治县
卫辉|卫辉市
科右前旗|科右前旗市
祁县
开封|开封县
太康|太康县
汉川|汉川市
新兴|新兴县
宜州|宜州市
平桂|平桂市
徐汇|徐汇区
站前|站前区
千阳|千阳县
八宿|八宿县
怒江|怒江市
和平|和平市
乌什|乌什县
安阳|安阳县
昆明|昆明市
海口|海口市
金水|金水区
龙亭|龙亭区
美兰|美兰区
龙潭|龙潭区
惠民|惠民县
睢县
中牟|中牟县
堆龙德庆|堆龙德庆区
长子|长子县
朔州|朔州市
青铜峡|青铜峡市
永康|永康市
东乡|东乡区
内江|内江市
莆田|莆田市
林西|林西县
巴东|巴东县
红古|红古区
渭源|渭源县
岳普湖|岳普湖县
铜梁|铜梁区
雁峰|雁峰区
阳原|阳原县
古丈|古丈县
西秀|西秀区
丽水|丽水市
云林|云林市
南康|南康区
硚口|硚口区
涿州|涿州市
连山壮族瑶族|连山壮族瑶族自治县
澄迈|澄迈县
前锋|前锋区
中山|中山市
梧州|梧州市
许昌|许昌县
佛冈|佛冈县
黎平|黎平县
汤旺河|汤旺河区
西峰|西峰区
元宝山|元宝山区
沈丘|沈丘县
石砫土家族|石砫土家族自治县
连南瑶族|连南瑶族自治县
卧龙|卧龙区
尖草坪|尖草坪区
图们|图们市
临安|临安市
宁远|宁远县
和阗地|和阗地区
宾川|宾川县
垦利|垦利区
桃园|桃园市
景东彝族|景东彝族自治县
邕宁|邕宁区
都江堰|都江堰市
龙沙|龙沙区
上饶|上饶市
凯里|凯里市
黄岛|黄岛区
科尔沁|科尔沁区
和平|和平县
凤冈|凤冈县
合江|合江县
自贡|自贡市
葭县
金门|金门县
红星|红星区
广平|广平县
桓台|桓台县
长子|长子市
雨花台|雨花台区
蚌山|蚌山区
莲池|莲池市
哈密|哈密市
瓜州|瓜州县
尖山|尖山区
横山|横山区
白云|白云区
福山|福山区
象山|象山县
定州|定州市
宁河|宁河县
大荔|大荔县
上高|上高县
开福|开福区
凉山|凉山市
宜春|宜春市
新淦|新淦县
樟树|樟树市
荆门|荆门市
阜城|阜城县
成安|成安县
兰考|兰考县
魏都|魏都区
衡南|衡南县
昆都仑|昆都仑区
锦州|锦州市
林芝|林芝县
珲春|珲春市
息烽|息烽县
徐闻|徐闻县
吉隆|吉隆县
丰满|丰满市
门头沟|门头沟区
宣化|宣化县
桃江|桃江县
鄂州|鄂州市
许昌|许昌市
沙县
昌邑|昌邑市
方正|方正县
盐山|盐山县
连城|连城县
永寿|永寿县
宜兴|宜兴市
盘龙|盘龙区
兴国|兴国县
即墨|即墨市
湘阴|湘阴县
泽库|泽库县
绛县
梨树|梨树县
洪洞|洪洞县
袁州|袁州区
温江|温江区
琼中黎族苗族|琼中黎族苗族自治县
桂林|桂林市
西固|西固区
双柏|双柏县
南昌|南昌市
江海|江海区
岱岳|岱岳区
芷江侗族|芷江侗族自治县
宜宾|宜宾县
海原|海原县
河口|河口区
沙坡头|沙坡头区
鲁甸|鲁甸县
彭阳|彭阳县
和平|和平区
成武|成武县
威远|威远县
路北|路北市
宜秀|宜秀区
甘德|甘德县
太仆寺旗|太仆寺旗
伊宁|伊宁县
杜集|杜集区
和林格尔|和林格尔县
洛宁|洛宁县
柳北|柳北区
屯留|屯留县
临川|临川区
桐乡|桐乡市
龙凤|龙凤市
永春|永春县
弥勒|弥勒市
迁西|迁西县
合浦|合浦县
澜沧拉祜族|澜沧拉祜族自治县
唐河|唐河县
延庆|延庆区
芜湖|芜湖市
张北|张北县
坡头|坡头区
庆云|庆云县
龙口|龙口市
甘井子|甘井子区
海阳|海阳市
青山湖|青山湖区
沽源|沽源县
犍为|犍为县
藁城|藁城市
阳东|阳东市
平顺|平顺县
文登|文登市
怀宁|怀宁县
贵南|贵南县
白云|白云市
麻山|麻山区
黔西南|黔西南市
临清|临清市
榆次|榆次区
内黄|内黄县
万柏林|万柏林区
大悟|大悟县
东海|东海县
唐海|唐海县
官渡|官渡区
奉新|奉新县
德令哈|德令哈市
蓟州|蓟州市
江州|江州市
鄂温克旗|鄂温克旗市
千山|千山区
路南|路南市
江源|江源区
怀仁|怀仁县
虎林|虎林市
浑江|浑江区
永定|永定区
高县
枣强|枣强县
孙吴|孙吴县
平坝|平坝区
萝岗|萝岗区
郾城|郾城区
江东|江东区
正蓝旗|正蓝旗
琼山|琼山区
石台|石台县
化州|化州市
安国|安国市
洛阳|洛阳市
寿阳|寿阳县
金寨|金寨县
庄河|庄河市
乡城|乡城县
芒市
城区
静宁|静宁县
伊州|伊州区
北湖|北湖区
阿鲁旗|阿鲁旗市
怀远|怀远县
安邱|安邱市
青州|青州市
九华山|九华山市
太和|太和区
达日|达日县
兖州|兖州区
本溪满族|本溪满族自治县
孙吴|孙吴市
新化|新化县
修文|修文县
当雄|当雄县
户县
萍乡|萍乡市
福田|福田区
双清|双清区
崇左|崇左市
廊坊|廊坊市
江永|江永县
泌阳|泌阳县
渠县
容县
集安|集安市
纳溪|纳溪区
六盘水|六盘水市
富民|富民县
仁和|仁和区
南康|南康市
枣庄|枣庄市
梁平|梁平县
赞皇|赞皇县
喀什|喀什市
九台|九台区
秭归|秭归县
五常|五常市
台江|台江县
郴州|郴州市
达县
潮阳|潮阳区
灵宝|灵宝市
武威|武威市
雅安|雅安市
乾安|乾安县
回民|回民市
东丰|东丰县
高明|高明区
云安|云安区
阿拉善右旗|阿拉善右旗
武邑|武邑县
路北|路北区
双塔|双塔区
武平|武平县
耒阳|耒阳市
大埔|大埔县
万秀|万秀区
永嘉|永嘉县
正安|正安县
甘南藏族|甘南藏族自治州
邵东|邵东县
渝中|渝中区
扶绥|扶绥县
横县
元阳|元阳县
凌云|凌云市
陆良|陆良县
德安|德安县
陆丰|陆丰市
南召|南召县
夷陵|夷陵区
南关|南关区
南丰|南丰县
景谷傣族彝族|景谷傣族彝族自治县
泊头|泊头市
渭南|渭南市
沙雅|沙雅县
黑山|黑山市
北安|北安市
黄梅|黄梅县
霞山|霞山区
张家界|张家界市
慈溪|慈溪市
山阳|山阳县
如皋|如皋市
赫山|赫山区
乌海|乌海市
利川|利川市
安化|安化县
扎兰屯|扎兰屯市
泰山|泰山区
海南|海南省
文圣|文圣区
苍梧|苍梧县
博湖|博湖县
大宁|大宁县
阜平|阜平县
任丘|任丘市
杭锦旗|杭锦旗
陇川|陇川县
镇远|镇远县
泸定|泸定县
云龙|云龙区
剑阁|剑阁县
金平|金平区
呼和浩特|呼和浩特市
大竹|大竹县
达茂旗|达茂旗市
环翠|环翠区
新乡|新乡市
忠县
潮安|潮安县
资兴|资兴市
石棉|石棉县
乡宁|乡宁县
平湖|平湖市
电白|电白区
萧县
马关|马关县
抚顺|抚顺县
凤县
海淀|海淀区
西林|西林市
吉阳|吉阳市
清河门|清河门区
平阴|平阴县
宣化|宣化区
桃源|桃源县
零陵|零陵区
萧山|萧山区
南投|南投市
新吴|新吴市
昌都|昌都县
新荣|新荣区
抚宁|抚宁区
溧水|溧水区
康巴什|康巴什区
大田|大田县
星子|星子县
澧县
西乡塘|西乡塘区
乌兰察布|乌兰察布市
君山|君山区
友好|友好市
获嘉|获嘉县
林周|林周县
民和|民和市
利津|利津县
大洼|大洼区
邢台|邢台县
中站|中站区
越西|越西县
崇阳|崇阳县
谢通门|谢通门县
土左旗|土左旗市
东宝|东宝区
贺州|贺州市
项城|项城市
红原|红原县
岑溪|岑溪市
简阳|简阳市
山城|山城区
鄠邑|鄠邑区
路南|路南区
万载|万载县
长安|长安市
广安|广安市
雷州|雷州市
乐陵|乐陵市
兴宁|兴宁市
碑林|碑林市
盘州|盘州市
利辛|利辛县
晴隆|晴隆县
宜兰|宜兰市
固阳|固阳县
碧江|碧江区
十堰|十堰市
益阳|益阳市
梁山|梁山县
会昌|会昌县
台东|台东市
巨鹿|巨鹿县
百色|百色市
江达|江达县
兰溪|兰溪市
茅箭|茅箭区
宣威|宣威市
云安|云安县
天等|天等县
新平彝族傣族|新平彝族傣族自治县
太原|太原市
芗城|芗城区
辛集|辛集市
湖口|湖口县
鹿邑|鹿邑县
四会|四会市
牡丹|牡丹区
金安|金安区
稷山|稷山县
东坡|东坡区
文山|文山市
子长|子长县
都兰|都兰县
塔城|塔城市
吕梁|吕梁市
秀洲|秀洲区
九台|九台市
于田|于田县
东辽|东辽县
西岗|西岗区
晋江|晋江市
威信|威信县
宕昌|宕昌县
江宁|江宁区
栾川|栾川县
梅州|梅州市
崇礼|崇礼县
南岔|南岔区
苏尼特左旗|苏尼特左旗
丰南|丰南区
潢川|潢川县
天镇|天镇县
理塘|理塘县
伊宁|伊宁市
宏伟|宏伟区
清新|清新市
岐山|岐山县
岷县
丰台|丰台区
临淄|临淄区
沅陵|沅陵县
洱源|洱源县
神木|神木县
阿拉山口|阿拉山口市
庆安|庆安县
宜州|宜州区
崇安|崇安区
宜章|宜章县
金川|金川区
霸州|霸州市
永兴|永兴县
盩厔|盩厔县
沿滩|沿滩区
沙湾|沙湾县
定襄|定襄县
开州|开州区
灵寿|灵寿县
立山|立山区
围场满族蒙古族|围场满族蒙古族自治县
新兴|新兴区
东昌府|东昌府区
库车|库车县
陈仓|陈仓区
额尔古纳|额尔古纳市
旌阳|旌阳区
吴起|吴起县
华州|华州市
青羊|青羊区
肃南裕固族|肃南裕固族自治县
休宁|休宁县
楚雄彝族|楚雄彝族自治州
安塞|安塞县
桂东|桂东县
勐腊|勐腊县
茂港|茂港区
隰县
新乐|新乐市
顺庆|顺庆区
理县
道外|道外区
南宁|南宁市
雨花|雨花市
洵阳|洵阳县
梅河口|梅河口市
罗山|罗山县
雒南|雒南县
乐业|乐业市
咸宁|咸宁市
常德|常德市
甘泉|甘泉县
江川|江川区
漳平|漳平市
瑞金|瑞金市
杂多|杂多县
郃阳|郃阳县
藁城|藁城区
新昌|新昌县
清水河|清水河县
冷水江|冷水江市
新津|新津县
天桥|天桥市
德庆|德庆县
武强|武强县
甘州|甘州区
浦东|上海浦东|浦东新区
湘潭|湘潭县
湖滨|湖滨区
海盐|海盐县
路桥|路桥区
云和|云和县
涿鹿|涿鹿县
东光|东光县
筠连|筠连县
那坡|那坡县
万安|万安县
历下|历下区
镇宁布依族苗族|镇宁布依族苗族自治县
青山|青山市
隆昌|隆昌县
殷都|殷都区
白朗|白朗县
鄂伦春自治旗|鄂伦春自治旗
沂水|沂水县
岚县
黄州|黄州区
和龙|和龙市
乌伊岭|乌伊岭区
宁阳|宁阳县
横峰|横峰县
印江土家族苗族|印江土家族苗族自治县
奇台|奇台县
沾益|沾益县
东区
相城|相城区
花莲|花莲市
蔚县
鹤城|鹤城区
平遥|平遥县
平舆|平舆县
小河|小河区
东至|东至县
五华|五华县
椒江|椒江区
鄂尔多斯|鄂尔多斯市
卫滨|卫滨区
屏边苗族|屏边苗族自治县
丹东|丹东市
辽宁|辽宁省
城步苗族|城步苗族自治县
清苑|清苑县
云溪|云溪区
沈邱|沈邱县
师宗|师宗县
大理|大理州|大理市
呼图壁|呼图壁县
竞秀|竞秀市
婺川仡佬族苗族|婺川仡佬族苗族自治县
兴安盟|兴安盟市
福建|福建省
隆化|隆化县
龙文|龙文区
孝昌|孝昌县
吉木萨尔|吉木萨尔县
英吉沙|英吉沙县
诸暨|诸暨市
乌恰|乌恰县
黄平|黄平县
天桥|天桥区
云安|云安市
寻甸回族彝族|寻甸回族彝族自治县
梅县
南明|南明区
水磨沟|水磨沟区
台儿庄|台儿庄区
新绛|新绛县
大姚|大姚县
三台|三台县
九寨沟|九寨沟县
松潘|松潘县
江口|江口县
达拉特旗|达拉特旗
凤翔|凤翔县
金山|金山市
小金|小金县
富裕|富裕县
大渡口|大渡口区
麦盖提|麦盖提县
习水|习水县
平潭|平潭县
宁县
南靖|南靖县
广安|广安区
金沙|金沙县
清镇|清镇市
宜阳|宜阳县
宝清|宝清县
三门峡|三门峡市
梁河|梁河县
宾县
高平|高平市
乌兰|乌兰县
铜陵|铜陵市
武川|武川县
兴业|兴业市
富顺|富顺市
五莲|五莲县
舒兰|舒兰市
吉水|吉水县
吴兴|吴兴区
海兴|海兴县
喀左|喀左市
通城|通城县
三门|三门县
龙岗|龙岗区
宽城|宽城区
济南|济南市
酉阳土家族苗族|酉阳土家族苗族自治县
西林|西林县
鄠县
铁岭|铁岭县
建安|建安区
电白|电白县
镇巴|镇巴县
贵池|贵池区
永善|永善县
江孜|江孜县
聂荣|聂荣县
润州|润州区
台中|台中市
连江|连江县
阳山|阳山县
水富|水富县
爱辉|爱辉区
英德|英德市
单县
绥宁|绥宁县
嘉义|嘉义市
南海|南海市
南皮|南皮县
河西|河西区
广灵|广灵县
德惠|德惠市
路环岛|路环岛市
龙凤|龙凤区
沙河口|沙河口区
全南|全南市
班戈|班戈县
攀枝花|攀枝花市
大冶|大冶市
延寿|延寿县
滨州|滨州市
乐都|乐都县
惠安|惠安县
峡江|峡江县
鹤山|鹤山区
阿里|阿里市
宜丰|宜丰县
甘肃|甘肃省
岳池|岳池县
蒙阴|蒙阴县
马尔康|马尔康市
南雄|南雄市
陕州|陕州市
浠水|浠水县
伊州|伊州市
定安|定安县
六枝特|六枝特区
容城|容城县
松北|松北区
钟楼|钟楼区
梁子湖|梁子湖区
泾源|泾源县
恩平|恩平市
台前|台前县
赵县
玉溪|玉溪市
开县
林芝地|林芝地区
富阳|富阳区
漠河|漠河市
白沙黎族|白沙黎族自治县
隆安|隆安县
道真仡佬族苗族|道真仡佬族苗族自治县
马龙|马龙市
牡丹江|牡丹江市
梅县|梅县市
灵璧|灵璧县
钟山|钟山区
潼南|潼南区
抚顺|抚顺市
河间|河间市
娄烦|娄烦县
铁力|铁力市
黄骅|黄骅市
滕州|滕州市
通化|通化市
奉化|奉化市
通江|通江县
汉滨|汉滨区
庆城|庆城县
天峻|天峻县
天峨|天峨县
南城|南城市
沁县
高要|高要市
阳谷|阳谷县
合水|合水县
达川|达川区
津市市
崇信|崇信县
西山|西山市
蒙城|蒙城县
交城|交城县
雷山|雷山县
淮安|淮安区
博白|博白县
德宏|德宏市
福安|福安市
嘉祥|嘉祥县
九龙坡|九龙坡区
精河|精河县
通河|通河县
雷波|雷波县
东阿|东阿县
醴陵|醴陵市
天门|天门市
滨海新|滨海新区
双鸭山|双鸭山市
东河|东河区
比如|比如市
商雒|商雒市
陕西|陕西省
乃东|乃东区
洮南|洮南市
吉安|吉安市
回民|回民区
徽州|徽州区
五华|五华区
城东|城东区
繁峙|繁峙县
广昌|广昌县
克州|克州市
莱西|莱西市
渭滨|渭滨区
吴江|吴江区
五河|五河县
长沙|长沙市
义安|义安区
广汉|广汉市
永德|永德县
湖里|湖里区
上杭|上杭县
昌乐|昌乐县
东山|东山市
万柏林|万柏林市
台南|台南市
安次|安次区
松江|松江区
察哈尔右翼中旗|察哈尔右翼中旗
绥化|绥化市
咸丰|咸丰县
新县
阳朔|阳朔县
裕华|裕华区
科尔沁左翼后旗|科尔沁左翼后旗
绿春|绿春县
云岩|云岩区
茂南|茂南区
新宁|新宁县
金明|金明区
石埭|石埭县
闽侯|闽侯县
灌南|灌南县
互助土族|互助土族自治县
仪征|仪征市
江南|江南区
嫩江|嫩江县
民乐|民乐县
共青城|共青城市
保靖|保靖县
荣县
龙湖|龙湖区
囊谦|囊谦县
沙依巴克|沙依巴克区
槐荫|槐荫区
且末|且末县
佳县
西林|西林区
景宁畲族|景宁畲族自治县
无锡|无锡市
集宁|集宁区
大兴|大兴区
友好|友好区
昭化|昭化市
东乌珠穆沁旗|东乌珠穆沁旗
云浮|云浮市
龙井|龙井市
德化|德化县
察雅|察雅县
凤阳|凤阳县
资中|资中县
翁牛特旗|翁牛特旗
西昌|西昌市
永城|永城市
高昌|高昌市
龙门|龙门县
吉县
水城|水城县
海棠|海棠市
泸水|泸水市
元江哈尼族彝族傣族|元江哈尼族彝族傣族自治县
海沧|海沧区
托克逊|托克逊县
梁园|梁园区
果洛藏族|果洛藏族自治州
钢城|钢城区
娄星|娄星区
邛崃|邛崃市
鼓楼|鼓楼区
蒙山|蒙山县
孟州|孟州市
永年|永年县
南岳|南岳区
彰武|彰武县
通州|通州区
乳山|乳山市
东洲|东洲区
宜城|宜城市
同仁|同仁县
大新|大新县
汝阳|汝阳县
安顺|安顺市
市辖区
化隆回族|化隆回族自治县
黑龙江|黑龙江省
昂昂溪|昂昂溪区
冠县
昌江|昌江区
博罗|博罗县
巴里坤哈萨克|巴里坤哈萨克自治县
彬县
城西|城西区
湘潭|湘潭市
东兴|东兴区
东山|东山区
榆社|榆社县
临高|临高县
青县
栖霞|栖霞区
洪湖|洪湖市
建湖|建湖县
防城港|防城港市
略阳|略阳县
元宝|元宝区
大庾|大庾县
黔江|黔江区
玛曲|玛曲县
鱼峰|鱼峰区
珠海|珠海市
带岭|带岭区
昌吉|昌吉市
邻水|邻水县
靖江|靖江市
莱芜|莱芜市
辰溪|辰溪县
巴马瑶族|巴马瑶族自治县
涪陵|涪陵区
桥西|桥西市
石楼|石楼县
晋中|晋中市
宾阳|宾阳县
嵩明|嵩明县
邹平|邹平县
山南|山南市
那曲|那曲县
洪山|洪山区
振兴|振兴区
高港|高港区
安居|安居区
通许|通许县
康县
伊犁哈萨克|伊犁哈萨克自治州
鄯善|鄯善县
青川|青川县
邯郸|邯郸县
沁水|沁水县
尉犁|尉犁县
大东|大东区
连州|连州市
弋阳|弋阳县
谢家集|谢家集区
从化|从化区
铜官|铜官区
阿拉善左旗|阿拉善左旗
建平|建平县
苏州|苏州市
林口|林口县
崇明|崇明县
新丰|新丰县
福贡|福贡县
西夏|西夏区
石林彝族|石林彝族自治县
鹿寨|鹿寨县
镇原|镇原县
长安|长安区
泰州|泰州市
赤城|赤城县
石河子|石河子市
雨湖|雨湖区
墨竹工卡|墨竹工卡县
上蔡|上蔡县
兴隆|兴隆县
奈曼旗|奈曼旗
靖州苗族侗族|靖州苗族侗族自治县
光山|光山县
防城|防城区
普安|普安县
惠农|惠农区
固安|固安县
北镇|北镇市
武昌|武昌市
东区|东区市
牙克石|牙克石市
永州|永州市
敦煌|敦煌市
翁源|翁源县
来宾|来宾市
思茅|思茅区
广德|广德县
沭阳|沭阳县
北塔|北塔区
赤水|赤水市
嵩县
港口|港口区
静安|静安区
福绵|福绵区
博乐|博乐市
温泉|温泉县
海曙|海曙区
利通|利通区
朝阳|朝阳市
独山子|独山子区
海北藏族|海北藏族自治州
顺城|顺城区
荣昌|荣昌区
乌尔禾|乌尔禾区
定边|定边县
建始|建始县
柳河|柳河县
邹城|邹城市
郧西|郧西县
花垣|花垣县
连山|连山区
岳西|岳西县
虔南|虔南县
铜梁|铜梁市
赣州|赣州市
渝北|渝北区
永丰|永丰县
抚州|抚州市
昌平|昌平区
颍泉|颍泉区
柯桥|柯桥区
华宁|华宁县
武宣|武宣县
琅琊|琅琊区
新界|新界市
渑池|渑池县
嵊州|嵊州市
赫章|赫章县
三都水族|三都水族自治县
翠峦|翠峦区
弥勒|弥勒县
盐源|盐源县
陇西|陇西县
卢氏|卢氏市
原平|原平市
阜新蒙古族|阜新蒙古族自治县
讷河|讷河市
天台|天台县
皇姑|皇姑区
汝南|汝南县
柯桥|柯桥市
留坝|留坝县
赣县
清流|清流县
白城|白城市
凤台|凤台县
措勤|措勤县
玉山|玉山县
浮山|浮山县
武乡|武乡县
荣昌|荣昌县
海勃湾|海勃湾区
灞桥|灞桥区
茂名|茂名市
安定|安定区
任县
拱墅|拱墅区
城子河|城子河区
安丘|安丘市
湛河|湛河区
新蔡|新蔡县
鹿城|鹿城区
彭山|彭山区
滑县
五大连池|五大连池市
雁山|雁山区
卡若|卡若区
大丰|大丰区
浚县
乐亭|乐亭县
和布克赛尔蒙古|和布克赛尔蒙古自治县
镇平|镇平县
观山湖|观山湖区
丹凤|丹凤县
韩城|韩城市
泰来|泰来县
平远|平远县
安徽|安徽省
新青|新青区
乌拉特后旗|乌拉特后旗
中原|中原区
洛隆|洛隆县
贡嘎|贡嘎县
洋县
汶川|汶川县
双台子|双台子区
双湖|双湖市
冷湖|冷湖市
舟山|舟山市
阿克陶|阿克陶县
满洲里|满洲里市
微山|微山县
福泉|福泉市
日喀则|日喀则市
港北|港北区
临夏|临夏县
黄南藏族|黄南藏族自治州
偃师|偃师市
澄海|澄海区
多伦|多伦县
璧山|璧山县
婺源|婺源县
蒸湘|蒸湘区
舞钢|舞钢市
西华|西华县
将乐|将乐县
海港|海港区
五台|五台县
井冈山|井冈山市
大化瑶族|大化瑶族自治县
遂平|遂平县
城北|城北区
崖州|崖州市
白山|白山市
黄冈|黄冈市
洞口|洞口县
北票|北票市
尖扎|尖扎县
长治|长治县
阿拉尔|阿拉尔市
秦皇岛|秦皇岛市
上城|上城区
花山|花山区
塔什库尔干塔吉克|塔什库尔干塔吉克自治县
西峡|西峡县
玉门|玉门市
华亭|华亭县
扶风|扶风县
荣成|荣成市
东西湖|东西湖区
攸县
文水|文水县
洮北|洮北区
宝兴|宝兴县
清新|清新县
龙城|龙城区
禹会|禹会区
榆中|榆中县
小店|小店区
监利|监利县
城阳|城阳区
明光|明光市
灵丘|灵丘县
彭水苗族土家族|彭水苗族土家族自治县
武陟|武陟县
盐边|盐边县
昌图|昌图县
泗县
丰泽|丰泽区
道孚|道孚县
庆阳|庆阳市
成县
掇刀|掇刀区
西和|西和县
东营|东营区
马龙|马龙县
察布查尔锡伯|察布查尔锡伯自治县
九江|九江县
井陉|井陉县
秦安|秦安县
合川|合川区
漾濞彝族|漾濞彝族自治县
无极|无极市
天元|天元区
阳明|阳明区
道县
环江毛南族|环江毛南族自治县
锦江|锦江市
余杭|余杭区
庐江|庐江县
贵定|贵定县
金东|金东区
乐都|乐都市
八公山|八公山区
永济|永济市
嘉荫|嘉荫县
临桂|临桂区
玛多|玛多县
猇亭|猇亭区
费县
玉树|玉树县
永和|永和县
肥东|肥东县
马村|马村区
宜良|宜良县
北林|北林市
富县
越秀|越秀区
长兴|长兴县
文峰|文峰区
眉山|眉山市
特克斯|特克斯县
瑷珲|瑷珲区
雁江|雁江区
永仁|永仁县
潜山|潜山县
碌曲|碌曲县
永新|永新县
商河|商河县
南充|南充市
平江|平江县
宝塔|宝塔区
绥芬河|绥芬河市
张家港|张家港市
土右旗|土右旗市
乾县
红山|红山区
常熟|常熟市
武胜|武胜县
大城|大城县
章邱|章邱区
金乡|金乡县
于都|于都县
乐都|乐都区
桦川|桦川县
信宜|信宜市
海棠|海棠区
苍溪|苍溪县
邱县
长葛|长葛市
四子王旗|四子王旗
保山|保山市
锡林郭勒盟|锡林郭勒盟
左贡|左贡县
固始|固始县
河曲|河曲县
喀喇沁旗|喀喇沁旗
改则|改则县
夏县
无极|无极县
昌都|昌都市
察隅|察隅县
富宁|富宁县
抚宁|抚宁县
巴楚|巴楚县
沛县
临江|临江市
红花岗|红花岗区
西城|西城区
平山|平山县
武冈|武冈市
新竹|新竹市
清苑|清苑区
博山|博山区
怀安|怀安县
化德|化德县
博望|博望区
阳新|阳新县
库伦旗|库伦旗
独山|独山县
石嘴山|石嘴山市
巴彦淖尔|巴彦淖尔市
淮北|淮北市
晋宁|晋宁县
扎囊|扎囊县
治多|治多县
乳源瑶族|乳源瑶族自治县
贵港|贵港市
宁明|宁明县
萨迦|萨迦县
崇明|崇明区
久治|久治市
揭东|揭东市
揭西|揭西县
祁东|祁东县
灵邱|灵邱县
柳城|柳城县
普定|普定县
遵化|遵化市
聂拉木|聂拉木县
三穗|三穗县
庆元|庆元县
城口|城口县
坪山|坪山区
枞阳|枞阳县
鹿泉|鹿泉市
垫江|垫江县
西充|西充县
鸡西|鸡西市
缙云|缙云县
抚远|抚远县
博尔塔拉|博尔塔拉市
敖汉旗|敖汉旗
固镇|固镇县
黄陵|黄陵县
桦南|桦南县
汤原|汤原县
封丘|封丘县
凤泉|凤泉区
茂县
武宁|武宁县
卓资|卓资县
东宁|东宁市
涧西|涧西区
二七|二七区
新抚|新抚区
坡头|坡头市
阿拉善盟|阿拉善盟市
丹阳|丹阳市
武功|武功县
栖霞|栖霞市
钟祥|钟祥市
红河|红河县
修水|修水县
平凉|平凉市
远安|远安县
盐湖|盐湖区
兴城|兴城市
金平苗族瑶族傣族|金平苗族瑶族傣族自治县
安乡|安乡县
苏尼特右旗|苏尼特右旗
白下|白下区
齐齐哈尔|齐齐哈尔市
思南|思南县
坊子|坊子区
罗平|罗平县
洛龙|洛龙区
竞秀|竞秀区
永定|永定县
南部|南部县
友谊|友谊市
嘉黎|嘉黎县
磴口|磴口县
瓦房店|瓦房店市
京口|京口区
高阳|高阳县
合阳|合阳县
泰安|泰安市
兴宁|兴宁区
丹巴|丹巴县
利州|利州区
临泽|临泽县
大武口|大武口区
台山|台山市
勉县
嘉善|嘉善县
禹王台|禹王台区
堆龙德庆|堆龙德庆县
阜南|阜南县
确山|确山县
东港|东港市
平乐|平乐县
公主岭|公主岭市
海晏|海晏县
平山|平山区
噶尔|噶尔县
蓬安|蓬安县
福海|福海县
祁连|祁连县
灵山|灵山市
太白|太白市
洞头|洞头区
宽城满族|宽城满族自治县
木兰|木兰县
招远|招远市
临桂|临桂县
科右中旗|科右中旗市
伍家岗|伍家岗区
共和|共和市
集贤|集贤县
巧家|巧家县
宁海|宁海县
普洱|普洱市
七台河|七台河市
贵州|贵州省
班玛|班玛县
石家庄|石家庄市
建宁|建宁县
永福|永福县
保定|保定市
莘县
香格里拉|香格里拉市
富拉尔基|富拉尔基区
东胜|东胜区
晋州|晋州市
西安|西安区
枣阳|枣阳市
轮台|轮台县
淄川|淄川区
惠阳|惠阳区
平阳|平阳县
巴州|巴州区
丰城|丰城市
古蔺|古蔺县
萨嘎|萨嘎县
隆子|隆子县
翼城|翼城县
寿县
承德|承德县
长乐|长乐市
慈利|慈利县
青冈|青冈县
福清|福清市
上林|上林县
同心|同心市
阳泉|阳泉市
岳阳|岳阳市
肇庆|肇庆市
新华|新华区
安多|安多县
韶关|韶关市
深圳|深圳市
广南|广南县
盐城|盐城市
曲沃|曲沃县
南海|南海区
浑南|浑南市
滨城|滨城区
贡井|贡井区
仙桃|仙桃市
西青|西青区
罗庄|罗庄区
江岸|江岸区
秦都|秦都区
桓仁满族|桓仁满族自治县
阿荣旗|阿荣旗
阿鲁科尔沁旗|阿鲁科尔沁旗
衡阳|衡阳市
梁平|梁平区
宜黄|宜黄县
宜都|宜都市
龙子湖|龙子湖区
红桥|红桥区
西工|西工区
安图|安图县
万宁|万宁市
双阳|双阳区
日喀则地|日喀则地区
播州|播州市
郯城|郯城县
北林|北林区
思明|思明区
湘桥|湘桥区
新建|新建县
商洛|商洛市
南宫|南宫市
鹰潭|鹰潭市
广州|广州市
麟游|麟游县
昭化|昭化区
达川|达川市
乌鲁木齐|乌鲁木齐县
代县
云城|云城区
皋兰|皋兰县
渝水|渝水区
丰宁满族|丰宁满族自治县
梅里斯达斡尔族|梅里斯达斡尔族区
朗县
广陵|广陵区
商州|商州区
壶关|壶关县
洛南|洛南县
萨尔图|萨尔图区
通山|通山县
沙坪坝|沙坪坝区
石城|石城市
曹妃甸|曹妃甸区
龙岩|龙岩市
醴泉|醴泉县
昭觉|昭觉县
上街|上街市
桥东|桥东区
矿区
淮安|淮安市
南丹|南丹县
华龙|华龙区
金溪|金溪县
鄢陵|鄢陵县
柘城|柘城县
汨罗|汨罗市
柯坪|柯坪县
通榆|通榆县
巨野|巨野县
镇康|镇康县
夏河|夏河县
德江|德江县
西沙|西沙市
滨江|滨江区
惠济|惠济区
二道江|二道江区
金州|金州区
吴忠|吴忠市
双流|双流县
兴安|兴安县
东台|东台市
德宏傣族景颇族|德宏傣族景颇族自治州
普陀|普陀区
芦山|芦山县
五峰土家族|五峰土家族自治县
田阳|田阳县
饶平|饶平县
东阳|东阳市
贾汪|贾汪区
下花园|下花园区
东平|东平县
象州|象州县
饶河|饶河县
忻城|忻城县
溪湖|溪湖区
龙胜各族|龙胜各族自治县
黟县
兴义|兴义市
和顺|和顺县
武定|武定县
泽普|泽普县
濠江|濠江区
喜德|喜德县
榕江|榕江县
江西|江西省
沾化|沾化市
三山|三山区
路桥|路桥市
岳阳|岳阳县
魏县
乐平|乐平市
苏仙|苏仙区
屏山|屏山县
行唐|行唐县
旅顺|旅顺市
杏花岭|杏花岭区
瓯海|瓯海区
宁国|宁国市
德州|德州市
赤峰|赤峰市
湘西土家族苗族|湘西土家族苗族自治州
金川|金川县
和阗|和阗县
金堂|金堂县
顺义|顺义区
山西|山西省
索县
洛川|洛川县
临西|临西县
滨海|滨海县
杭锦后旗|杭锦后旗
建昌|建昌县
黄岩|黄岩区
开州|开州市
若尔盖|若尔盖县
肇源|肇源县
钦州|钦州市
营口|营口市
景德镇|景德镇市
吉首|吉首市
腾冲|腾冲县
贡山独龙族怒族|贡山独龙族怒族自治县
烟台|烟台市
市南区
勃利|勃利县
歙县
万年|万年县
泸溪|泸溪县
北川羌族|北川羌族自治县
蓝田|蓝田县
新洲|新洲区
伽师|伽师县
运河|运河区
万全|万全县
格尔木|格尔木市
市北区
青秀|青秀区
兴化|兴化市
扎赉诺尔|扎赉诺尔市
玉龙纳西族|玉龙纳西族自治县
新右旗|新右旗市
遂昌|遂昌县
惠东|惠东县
曾都|曾都区
献县
浮梁|浮梁县
湘西|湘西市
海陵|海陵区
景县
平塘|平塘县
游仙|游仙区
青岛|青岛市
铁门关|铁门关市
墨脱|墨脱县
陕州|陕州区
巩义|巩义市
石拐|石拐区
卫东|卫东区
府谷|府谷县
锺山|锺山县
遵义|遵义县
工布江达|工布江达县
漯河|漯河市
新巴尔虎左旗|新巴尔虎左旗
北关|北关市
薛城|薛城区
六合|六合区
周村|周村区
山南地|山南地区
磁县
华州|华州区
道里|道里区
珙县
兴隆台|兴隆台区
延吉|延吉市
楚雄|楚雄市
开远|开远市
彝良|彝良县
泾阳|泾阳县
泗水|泗水县
安州|安州区
康乐|康乐县
苏家屯|苏家屯区
铁山|铁山区
南乐|南乐县
修武|修武县
大丰|大丰市
临泉|临泉县
金凤|金凤区
银川|银川市
如东|如东县
岢岚|岢岚县
禹城|禹城市
漳浦|漳浦县
宝丰|宝丰县
仙游|仙游县
凌海|凌海市
中山|中山区
新浦|新浦区
全椒|全椒县
闻喜|闻喜县
孝义|孝义市
萝北|萝北县
莲湖|莲湖区
雨山|雨山区
太平|太平区
比如|比如县
姚安|姚安县
巴林右旗|巴林右旗
鼎湖|鼎湖区
墨江哈尼族|墨江哈尼族自治县
营山|营山县
汉南|汉南区
西区
曲麻莱|曲麻莱县
爱民|爱民区
七星|七星区
南沙|南沙区
襄汾|襄汾县
柞水|柞水县
赣榆|赣榆县
管城回族|管城回族区
兴山|兴山区
拜泉|拜泉县
虹口|虹口区
忻州|忻州市
高淳|高淳县
郏县
怒江傈僳族|怒江傈僳族自治州
凤城|凤城市
洛江|洛江区
西平|西平县
调兵山|调兵山市
明溪|明溪县
侯马|侯马市
陵城|陵城市
南安|南安市
平川|平川区
汉台|汉台区
靖远|靖远县
霍尔果斯|霍尔果斯市
漳州|漳州市
淳化|淳化县
陵水黎族|陵水黎族自治县
阿图什|阿图什市
嘉禾|嘉禾县
乌拉特前旗|乌拉特前旗
屯溪|屯溪区
白碱滩|白碱滩区
康平|康平县
大名|大名县
清河|清河区
漠河|漠河县
武隆|武隆县
中卫|中卫市
徐州|徐州市
黎川|黎川县
仪陇|仪陇县
策勒|策勒县
海城|海城市
西安|西安市
汝城|汝城县
芝罘|芝罘区
文县
大祥|大祥区
石景山|石景山区
康马|康马县
英山|英山县
依兰|依兰县
望城|望城县
施秉|施秉县
明水|明水县
旌德|旌德县
天涯|天涯区
卡若|卡若市
海东|海东市
宁波|宁波市
东源|东源县
藤县
金门|金门市
南岸|南岸区
河北|河北省
青龙满族|青龙满族自治县
大庆|大庆市
播州|播州区
王益|王益区
福州|福州市
定陶|定陶区
房县
向阳|向阳区
义马|义马市
锦屏|锦屏县
建阳|建阳市
都昌|都昌县
斗门|斗门区
平房|平房区
融安|融安县
惠来|惠来县
阿瓦提|阿瓦提县
南开|南开市
济阳|济阳县
胶州|胶州市
山阳|山阳区
彭山|彭山市
郎溪|郎溪县
河南|河南省
千山|千山市
湘江新区|湘江新区市
临潭|临潭县
嘉陵|嘉陵区
龙江|龙江县
叶集|叶集市
临河|临河区
西乌珠穆沁旗|西乌珠穆沁旗
平武|平武县
雨花|雨花区
南漳|南漳县
城固|城固县
香港|香港特区政府|香港特区|香港特别行政区
澳门|澳门特区政府|澳门特区|澳门特别行政区
